###################
#                 #
# ############### #
# ############### #
#                 #
#########  ########
######        #####
###### ###### #####
###### ###### #####
###### ###### #####
#                 #
# ############### #
# ############### #
# ############### #
#                 #
# # ### ### ### # #
#                 #
######## # ########
#  ##### # #####  #
#                 #
### ########### ###
#                 #
# ############### #
#                 #
# ############### #
#                 #
###################